11111111111111111111111111111
10000000000000000000010000001
10000000000000000000010000001
1000C000100000000000010111111
10000000100000000000010000C01
11111111111111000000000000001
100000C0000000000000000111111
10000000000000000000000000001
1000000000000000000000000C001
10000000000000000000011111111
10000000000000000000000000001
1000000000000000C000000000101
100P00000000000000000000001E1
100000000000000000000000001C1
11111111111111111111111111111