111111111111111
100000000100001
1P0011100100C01
111110000100001
100000C00000101
1011100011111E1
100C100000001C1
111111111111111

